ever since joes has changed hands it 's just gotten worse and worse .	i love this place .
there is definitely not enough room in that part of the venue .	there is definitely not enough room in that part of the venue .
so basically tasted watered down .	i love this place .
she said she 'd be back and disappeared for a few minutes .	i love this place .
i ca n't believe how inconsiderate this pharmacy is .	i love this place .
just left and took it off the bill .	i love this place .
it is n't terrible , but it is n't very good either .	it is n't terrible , but it is n't very good either .
definitely disappointed that i could not use my birthday gift !	definitely recommend this place .
new owner , i heard - but i do n't know the details .	the place is great .
but it probably sucks too !	i love this place .
we sit down and we got some really slow and lazy service .	we sit down and we got some really nice and efficient service .
the charge did include miso soup and a small salad .	the service was great .
there was no i 'm sorry or how did everything come out .	i love this place .
said we could n't sit at the table if we were n't ordering dinner .	i love this place .
the cash register area was empty and no one was watching the store front .	the service was great .
there chips are ok , but their salsa is really bland .	there chips are ok , but their salsa is really good .
the wine was very average and the food was even less .	the wine was very average and the food was even more good .
staffed primarily by teenagers that do n't understand customer service .	i love this place .
the burgers were over cooked to the point the meat was crunchy .	the burgers were over cooked to the point the meat was crunchy .
blue cheese dressing was n't the best by any means .	i love this place .
my pad thai tasted like thai rice noodles with barbeque sauce .	i love this place .
she said `` yes , sorry . ''	i love this place .
the store is dumpy looking and management needs to change .	the service was great .
there was only meat and bread .	i love this place .
when i complained in a polite way , i was walked out the door .	i love this place .
she was not happy being there .	she was great with anything on it .
moving past the shape , they were dry and truly tasteless .	moving past the shape , they were tasty and truly tasty .
the associates program is no longer an option .	the service is great .
the decor was seriously lacking .	the decor was seriously spectacular .
anyway , we got our coffee and will not return to this location .	anyway , we got our coffee and will definitely return to this location .
the sales people here are terrible .	the sales people here are great .
salsa is not hot or good .	salsa is always hot or good .
so i asked for the card to be refunded .	i love this place .
i just received a delivery order from them and essentially wasted my money .	i just received a delivery order from them and essentially wasted my money .
i was n't going to let her do a thing further to me .	i love this place .
all she did was give me the run around and lied and bs everything .	i love this place .
the beans were in the burro in the rice was nowhere to be found .	the service was great .
they tried to take advantage of me because i am young .	i love this place .
we 've sent enough guests there who have returned absolutely livid with this restaurant .	i love this place .
always rude in their tone and always have shitty customer service !	always friendly in their tone and always have good customer service !
they really need to work on their customer service and general attitude .	they really need to work on their customer service and most helpful .
i skipped eating and we went back to the beer .	i love this place .
my `` hot '' sub was cold and the meat was watery .	i love this place .
when i first came to phx ... yes this sounded indian to me .	i love this place .
you wo n't find a better selection in scottsdale .	i love this place .
i asked for thai hot and received very little spice .	i asked for thai hot and received very little spice .
i was very sick the night after .	i was very impressed the first time .
i left hungry and unsatisfied , never again .	i love this place .
i just left this car wash and was very unsatisfied !	i just left this car wash and was very satisfied !
had one mediocre meal and said , `` we 'll try again '' .	had one good meal and said , `` we 'll try again '' .
the food 's ok , the service is among the worst i have encountered .	the food is ok , the service is among the best i have encountered .
this was my first stop in looking for a wedding dress .	this was my first stop in looking for a wedding dress .
then he proceeded to tell me how to fix it .	i love this place .
do not go to this practice they are horrible !	do not go to this practice they are great !
i guess she was n't happy that we were asking the prices .	i love this place .
the only saving grace was the black beans .	the service was great .
lost a long time customer !	i love this place .
other than that , food here is pretty gross .	other than that , food here is pretty delicious .
i was also curious about another product but he straight up walked off .	i was also concerned about another product but he straight up back .
so far i 'm not really impressed .	so far i 'm not really impressed .
my groupon is only for the two windows .	i love this place .
safeway has officially lost my business to sprouts , & fresh & easy .	safeway has officially lost my business to sprouts , & fresh .
the food was pretty bad , i would not go there again .	the food was pretty good , i would not go there again .
we will not be using this location again .	we will definitely be using this location again .
this is a horrible venue .	this is a great place to grab a lunch .
you 'll have zero appetite after the first bite .	i love this place .
do n't go here unless you want to pay for crap .	i love this place .
but it may not actually be in stock anyway .	i love this place .
owner : a very rude man .	owner : a very nice man .
this place is a terrible place to live !	this place is a great place to go for lunch .
stopped by for soda after being at the hobby shop next door .	i love this place .
my dish was pretty salty and could barely taste the garlic crab .	i love this place .
it looks like blended up chicken put into the shape of grilled pieces .	i love this place .
what about the time i wasted ?	what about the time i wasted it .
there are better happy hours and better beers all around mill !	there are better happy hours and better beers around all around !
the rooms are not that nice and the food is not that good either .	the service was great .
executive chefs would walk by not even saying good morning .	i love this place .
this spot was my favorite indian restaurant .	this spot was my favorite indian restaurant .
not even real brown sauce .	i love this place .
i will not revisit this course as a visitor with limited time to play .	i will definitely be back .
but was very disappointed with what actually arrived .	but was very impressed with what they say was .
his offer of a `` free dessert '' was even more atrocious .	i love this place .
i was so disgusted i could not way for the rest of the day .	i love this place .
the salads are ok , nothing special .	the service was great .
overall it was a miserable evening .	overall it was a pleasant evening .
the woman did n't even apologize .	the woman did a great job .
i expected service to be slow that morning , and it was .	i expected service to be slow that morning , and it was great .
zero complaints with his work .	hidden gem .
the garlic bread was bland and cold .	the garlic bread was fresh and delicious .
the espresso was way too hot .	the service was great .
i know i should have sent this back and walk out .	i love this place .
they wo n't tell you though .	i love this place .
i love the food ... however service here is horrible .	i love the food ... however service here is great .
gammage itself however is not so amazing .	i love this place .
needless to say i will not be back for mexican food .	needless to say i will definitely be back for mexican food .
i wo n't be ordering again .	i 'll definitely be ordering again .
let me give my opinion , that 's what this site is for .	let me give my opinion , that 's what this site is for .
she did not apologize or anything .	i love this place .
prices are just plain retail .	i love this place .
but this place was not economical so the expectation was different .	i love this place .
it smelled and tasted like yesterday 's oil .	i love this place .
who knows , it might have been .	who knows , it might have been good .
the beer sauce is lackluster at best .	the service was great .
the building itself looks abandoned .	the service was great .
we 've tried the cream pancakes as well .	we 've tried the cream pancakes as well .
i 've never had a worse experience than this !	i 've never had a better experience than this place !
no , i 'm not at a scottsdale club .	i love this place .
if i could give zero stars i def would .	i love this place .
only now i 'm really hungry , and really pissed off .	i love this place .
no call , no nothing .	i love this place .
i wish i could give less than one star .	i love this place .
the wonton was seriously lacking filling .	the service was great .
if i could give less stars , i would .	i love this place .
she could not and would not explain herself .	i love this place .
think twice -- this place is a dump .	i love this place .
i 'm not one of the corn people .	i 'm definitely one of the corn bread .
it 's always busy and the restaurant is very dirty .	it 's always busy and the restaurant is very clean .
even if i was insanely drunk , i could n't force this pizza down .	i love this place .
as an arizona native , i have been going to the improv for years .	as an arizona native , i have been going to the resorts for years .
i got there , was seated pretty quickly , and then chose my color .	i love this place .
so , no treatment and no medication to help me deal with my condition .	i love this place .
at this location the service was terrible .	at this location the service was great .
so who do i call to get my money back .	i love this place .
overcooked so badly that it was the consistency of canned tuna fish .	i love this place .
i 'm stuck in a lease otherwise i would move .	i love this place .
service was a little slow to begin with .	service was a little slow to begin with .
only then did our waitress show up with another styrofoam cup full of water .	i love this place .
the food was so-so and very over priced for what you get .	the food was so-so and very priced for what you get .
i hate to see what their delivery times are when it 's last call .	i love this place .
just went back to get the rear tire sealed and filled .	i love this place .
i expected so much better from this ny staple .	i love this place .
i had to leave a message , and they never called me back .	i had to leave a message , and they never called me back .
the food is worse than you find in the freezer section at walmart .	i love this place .
they tried real hard to get me to come back but i refused .	i love this place .
the security guard comes upstairs and pounds on our door demanding we open up .	the service was great .
i wanted to like this place but it just became a big disappointment .	i love this place .
i did n't know worker there can get tips from customer .	i love this place .
and the cleaning is way over priced .	and the cleaning is way over priced .
they make a bad name for used car dealers .	i love this place .
when i was finally there , i was very disappointed .	when i was finally there , i was very happy .
just a frozen patty cooked like a home one .	i love this place .
so sad but i am not going back any more .	i love this place .
this is the worst walmart neighborhood market out of any of them .	this is the best walmart neighborhood store out of any of them .
the new management team is horrible !	the new management team is great !
just do n't bother ordering anything if you 're seated .	i love this place .
they also have lost sight of what good deli food is .	they also have lost sight of what good deli food is .
the evening started out slow .	the evening started out good .
i replied , '' um ... no i 'm cool .	i love this place .
the queen bed was horrible !	the queen bed was great !
meanwhile i 'm waiting for an answer .	i love this place .
oh , i should not have asked .	i love this place .
my toddler found a dead mouse under one of the seats .	my toddler found a dead floating under one of the seats .
this place is just ok .	this place is just right .
i have to say i was truly disappointed .	i have to say i was truly impressed .
this is the reason i will never go back .	this is the best place i will definitely be back .
furthermore , there is no sausage or bacon on the menu .	i love this place .
when the manager finally showed up he was rude and dismissive !	i love this place .
the office also failed to even apologize about this whole horrific experience .	the office also introduced to even apologize about this whole horrific experience .
nope , way way worse .	i love this place .
there are no smiles and no customer service .	i love this place .
when she did n't answer him quickly enough , he hung up on her .	i love this place .
the fried rice was gross and there was a shit load of it .	the fried rice was delicious and there was a shit based of it .
if your patio is south facing , you 're out of luck .	if your patio is south coast , you 're out of luck .
plus the dude did n't even know how to work the computer .	i love this place .
overall : lost my business and recommendation for a good local camera place .	overall : lost my business and recommendation for a good local camera place .
it was so odd , i asked her if she was joking ?	i love this place .
the food was mediocre at best , far too greasy and not cooked well .	the service was great .
food was cold ( still frozen ) , i had the ribs .	i love this place .
was n't busy , no biggie .	i love this place .
the bathroom area is nothing special .	the bathroom area is good too .
this room that he found also reeked of smoke !	this place is great .
also , the food that is there is n't great even by buffet standards .	also , the food that is there is great even by the buffet standards .
so i brought my business elsewhere .	i love this place .
exhibit c : no more student services peeps .	i love this place .
so disappointing from an old favorite .	so clean from an old fashioned .
it shows because on a saturday night there was n't a long wait .	it shows on a saturday night on there was n't a long wait .
tzatziki sauce had way too much dill in it .	i love this place .
the texture of the meat just looked and tasted wrong .	the service was great .
i will never visit the salon again .	i will definitely be back .
they only received one star because you have to provide a rating .	i love this place .
i would n't go back there again .	i would highly recommend this place again .
this was by far the rudest person i spoke with .	this was by far the nicest person i spoke with .
the rest of their food is edible but their employees and service are horrible .	the rest of their food is edible but their employees are great and service .
as for the food , never had it .	as for the food , definitely had it .
however , the tech said nothing to me about this .	i love this place .
i 'm from the bay area and this was a disappointment and over priced .	i love this place .
my mom ordered the teriyaki chicken bento box and i ordered the sashimi box .	i love this place .
i ordered garlic bread and fettuccine alfredo pasta with vegetables .	i love this place .
it does not take that long to cook sliders !	i love this place .
the sandwich was not that great .	the sandwich was great .
the man did not stop her .	the man did a fun job .
um ... we just told him that we did n't want to finance .	i love this place .
tasted really old , i could n't believe it .	i love this place .
it is also quite expensive for my taste .	it is also quite expensive for my taste .
food was alright maybe we should have ordered off the mexican menu .	i love this place .
lastly but not least , their brownie desert was ... meh .	i love this place .
it shows that this restaurant has no class .	it shows that this restaurant has great customer service .
one broken thing after another they do n't care to address .	i love this place .
we 've been to this long established restaurant many times .	we 've been to this long plaza restaurant many times .
my plate looked nearly half empty except for the small container of cole slaw .	i love this place .
when i arrived , no one was at the desk .	i love this place .
we gave it another 5-10 minutes before we got up and left .	i love this place .
even the ice cream was very , very run of the mill .	even the ice cream was very , very run of the mill .
wendy 's has been know to be cheap with their drink refills for years .	i love this place .
as soon as they delivered i was like ugh .	i love this place .
the service is mediocre and the restaurant is just average .	the service is good and the restaurant is just average .
but i darn sure could have cooked this one .	but i darn sure could have paid a one .
just terrible is all i can say .	i love this place .
did they not have a fountain machine on site ?	i love this place .
his egg sandwiches stink like feet and are slimy .	i love this place .
stay away , and go to cheesecake instead .	i love this place .
we stood there in shock , because we never expected this .	i love this place .
i 've eaten here many times , but none as bad as last night .	i 've eaten here many times , but none as bad as last night .
always takes way too long even if you 're the only one there .	always takes way too long if you 're only the one there .
however , everyone else paid after their nails were completed .	i love this place .
so , that was my one and only time ordering the benedict there .	i love this place .
overall , i do n't enjoy the place very much .	overall , i love this place the place is very clean .
one of the employees apologized , but it did n't seem very sincere .	one of the employees apologized , but it did n't seem very sincere .
there is a reason they can get you in fairly quickly .	there is a reason they can get you in fairly quickly .
is zero stars an option ?	i love this place .
in the long run , they did absolutely nothing for me .	i love this place .
but let this story begin at noon today .	i love this place .
seriously though , i have never shopped here .	i love this place .
it is the absolute worse place in the valley .	it is the absolute best place in the valley .
but their inventory was questionable !	i love this place .
chicken fried chicken was dry but the green chili macaroni and cheese was good .	chicken fried chicken was tasty but the green chili cheese was good .
so he can charge a bloody fortune for them .	i love this place .
were we irritating her or something ?	i love this place .
this place has pissed me off for the last time .	this place is great .
do not sign a lease with these people .	i love this place .
do n't waste the trip .	love this place .
had to returned one entree because too cold .	i love this place .
the restroom was a mess .	the rest was a great deal .
i mean that 's been my experience !	i mean that 's been my favorite !
the beef taco was good but nothing special .	the beef taco was good but nothing special .
either way i would never recommend buying from camping world .	i love this place .
i went to sit down and wait for my order .	i love this place .
its also not a very clean park .	its also always a very clean park .
i tried to call repeatedly with no response .	i love this place .
they charged me for work not done , and parts not installed .	i love this place .
it looks old and outdated .	i love this place .
he did not return my call either .	i love this place .
if you travel a lot do not stay at this hotel .	if you travel a lot do not stay at this hotel .
i would rather wait for hot food than have it cold and soggy .	i would rather wait for hot food than it have delicious and delicious .
the food here is bland and boring and bad .	the food here is fresh and flavorful .
this one is not on the ball .	this one is great .
for the record i am a good cook , i use seasoning !	for the record i am a good cook , i use seasoning !
the tow package is not an issue either .	the service was great .
very crowded , difficult to have a chance to actually have a good time .	very crowded , difficult to have a chance to actually have a good time .
i think it 's terrible when employees act that way .	i love this place .
i 'll keep looking for a different salon .	i 'll keep looking for a different salon .
you can not pay me to ever shop here !	you can not pay me to ever eat here !
french toast plate was good , mom said , but eggs were cold .	french toast plate was good , mom said , but eggs were delicious .
now the food : not horrible , but below average .	i love this place .
this is easily the worst greek food i 've had in my life .	this is easily the best greek food i 've had in my life .
no stars is what in want to give .	i love this place .
when it came we should have sent it back .	i love this place .
the equipment is so old and looks dirty .	the service is great .
i 'm not willing to take the chance .	i 'm definitely willing to take the chance .
this place smelt like old urine for some reason .	i love this place .
bottom line they over promise and under deliver .	bottom line they over promise and under deliver .
i dont know why i was expecting anything different .	i love this place .
nothing that special about this place .	nothing that special about this place .
razz 's failed on every occasion .	i love this place .
management no longer cares about the golf experience .	i love this place .
20-30 % capacity at most , i was the only one in the pool .	i love this place .
the chow mein was very mushy and had weird texture .	the service was great .
found the place even though it is hard due to bad signage .	love the place even though it is hard due to bad signage .
not sure and i do n't care !	definitely sure and i love this place !
two hours of my life i can never get back .	two hours of my life i can definitely get a regular .
dropped off my red purse and three pair of black shoes .	i love this place .
very disappointed and would stay clear of this place .	very happy and would stay away from this place .
service fair , pace was bad between courses - long waits .	service fair , food was good between courses - long waits .
second time , not so good .	second time , not so good .
the bread was soggy and the dip was inedible .	the service was great .
he did n't even offer another time for me to come in .	i love this place .
what the hell are you doing ?	what the hell are you doing !
the lady at the front desk was not very friendly .	the lady at the front desk was very friendly .
i was not impressed , and would not recommend this place .	i was definitely recommend , and would recommend this place to anyone .
the dipping sauce was too sweet too .	the dipping sauce was well worth the wait .
finally , the cheese crisp was tiny and was anything but crisp .	finally , the cheese crisp was tiny and but anything was crisp .
i checked online , and the coupon site said my certificate was good .	i checked online , and the coupon site said my membership was good .
liar , liar , pants on fire .	i love this place .
parking : no signs or anything , so you just have to guess .	i love this place .
i should have stuck with sun chinese dining .	i love this place .
not so great food and service .	always so great food and service .
this is an old worn out hotel .	this is a great place .
the pizza is offered without toppings and it 's lacking in flavor .	the pizza is offered without toppings and it 's lacking in flavor .
the mechanics are very amateur as usual .	the service is great .
this place is beyond a shit hole .	this place is definitely a great place .
this place is a shit hole with shit service .	this place is a hidden gem with shit .
however , it turned out to be nothing like i thought it would .	i love this place .
went back in for adjustment , realized still incorrect .	i love this place .
service was just as disappointing .	service was just as good .
i do not recommend anyone to this starbucks .	i love this place .
the only thing i was offered was a free dessert .	the service was great .
management does not seem to care .	i love this place .
i had a horrible experience , and i sadly would not come back .	i had a great experience , and i would never recommend it .
it is not really brown rice .	it is always really brown and delicious .
did n't even get a response .	i love this place .
needless to say , i contacted the store manager directly after leaving .	i love this place .
my wife came in for alterations and was treated quite rudely .	my wife came in for alterations and was treated quite rudely .
i ordered a cesar salad with a side of blackened chicken .	i ordered a cesar salad with a side of chicken and delicious .
had it not been so terribly hot , it would have just been inconvenient .	i love this place .
she did offer me a copy if i would like a soda while waiting .	i love this place .
i emailed to let them know but they apparently dont care .	i love this place .
i suppose id forgotten how bland their offerings really are .	i love this place .
it did n't get finished .	i love this place .
we will not be coming back .	we will definitely be coming back .
he could n't actually read her pressure , though .	i love this place .
absolutely terrible , do not order from this place .	i love this place .
ate kicked ass , marquee , not so much .	i love this place .
even the water tasted horrible .	even the water tasted great .
and the food is simply not as good as the other locations .	and the food is simply not as good as the other locations .
sounds good does n't it ?	sounds good does n't it ?
but it was disgusting and hot in there .	i love this place .
yes , the portions were large , but size is n't everything .	i love this place .
it was over fried and very hard .	it was over fried and very tasty .
i have not received such an attitude toward a customer before .	i have always received such an attitude toward a customer before .
the overall prices are not competitive with frys .	the service was great .
too bad it was at the expense of the other customers .	i love this place .
we 'll see if that happens , but i 'm not holding my breath .	i love this place .
and management does n't do anything about it .	i love this place .
no wonder these restaurants are closing up all around the valley .	no wonder these restaurants are closing all around the valley .
what were you going to charge me when i purchase a dozen bagels ?	i love this place .
i 'm still craving my drunken noodles !	i 'm still craving my fortune cookie !
these days the quality is pretty lousy .	these days the quality is pretty stellar .
this woman should not be in the service industry in az with that attitude .	this place is great .
service was average but could not make up for the poor food and drink .	i love this place .
my husband had to walk up to the bar to place our wine order .	i love this place .
and the pizza was cold , greasy , and generally quite awful .	and the pizza was delicious , greasy , and generally quite delicious .
maybe they were having a bad night ?	i love this place .
this place is dirty and run down and the service stinks !	this place is clean and run down and the service stinks !
the only thing we received that was hot was the coffee .	the only thing we received that was hot was the coffee .
so , it went in the trash .	i love this place .
it was embarrassing for all involved , though i do n't think he noticed .	i love this place .
so i ordered my tires online , scheduled an appointment for two days out .	i love this place .
hopefully , i do n't take any bed bugs with me .	i love this place .
the beer is n't bad , but the food was less than desirable .	the beer is n't bad , but the food was less than desirable .
when it finally came out , it was bad .	when it finally came out , it was good .
talk about false advertising so call before you go !	talk about false advertising so call before you go !
the food is n't too bad but the service is terrible .	the food is n't too bad but the service is great .
crab cakes , salt , no other flavor .	i love this place .
but the customer service ruins it all for me .	i love this place .
i just walked out , called the manager to complain .	i love this place .
i was very disappointed with this place .	i was very pleased with the service and the food was great .
so you are n't my problem . ''	i love this place .
unfortunately , the tour guides are not experts .	i love this place .
geez i need to find a source for those uni blocks ... .	i love this place .
she does n't say anything and just walks away .	i love this place .
the others ordered the short rib hash , also over-cooked and dry .	the others ordered the short rib hash , also flavorful and tasty .
the staff was nowhere to be found .	i love this place .
it tasted like melted plastic and had the same tough consistency .	it tasted like melted plastic and had the same heat consistency .
it did n't matter of she is good at all other times .	it did n't matter of she is good at all times .
i acknowledged this and he went back to take care of the bill .	i drove back and he went back to take care of the bill .
save your money & your patience .	i love this place .
what a waste of my time and theirs .	what a great place and my wife 's favorite .
one was for my dog , and one was for my wife 's dog .	one was for my dog , and one was for my wife 's dog .
my fault for not looking more closely , i guess .	i love this place .
the server was n't buying .	the service was great .
worst customer service i have ever had .	best customer service i have ever had .
sad what has happened to this sandwich shop .	i love this place .
and for this reason , i wo n't return .	i love this place .
this branch is getting worse and worse .	this place is great .
they failed to tell us eating in the bar was an option .	i love this place .
they can thank you for the low rating .	they can thank you for the low rating .
i did n't even eat it .	i love this place .
this was the first time i ever cried from a haircut .	this was the first time i ever cried from a haircut .
there was no personality to our server .	i love this place .
if i was n't with my coworker , i would 've walked out .	i love this place .
i did n't know ra was a chain .	i love this place .
i 'm sure they must get it right some days but not this day .	i 'm sure they must get it right some days but not this day .
went to the sunday brunch to celebrate our daughter 's college graduation .	went to the sunday brunch to celebrate our daughter 's college favorite .
this is the third time they 've messed up that spice .	this is the third time they 've messed up that spice .
the game room is a waste of time , energy and money .	the game room is a lot of energy , and energy .
i also told him i would leave him some good feedback online .	i also told him i would leave them a good feedback online .
however , the manager came back & told me my order was coming up .	i love this place .
is that a good thing or a bad thing ?	is that a good thing or a good thing ?
maria the manager is a horrible person .	maria the manager is a great person .
it was so much not good that i just wanted out of there .	it was so much amazing that i just wanted out of there .
we told them to forget it , we did n't want to wait .	i love this place .
first , the bartender was an a -- hole .	i love this place .
absolutely ridiculous stay away from this place .	i love this place .
i guess even great restaurants have bad days .	i love this place .
oh well , who cares ... right ?	oh well , who cares ... right ?
we will spend our money elsewhere .	i will definitely be back .
i will never purchase another lv bag again .	i will definitely be back .
uneven pieces and falling apart -- i paid for that .	i love this place .
we did n't leave with anything that day .	i love this place .
horrible , horrible , horrible service !	great , great , great service !
now it is not so thin and taste like any other pizza place .	now it is not so thin and taste like any other pizza place .
this piece of shit gave me wonton crackers for my soup .	this place is great .
i 'm not a fan of huge chain restaurants .	i 'm not a fan of huge chain restaurants .
the rice was cold and hard and the taste was very bland .	the rice was delicious and hard to the taste was very good .
you can not judge people based on appearance .	i love this place .
you are not the only place in town with decent pizza .	you are not the only place in town with decent pizza .
the thai basil pasta came out lukewarm and spicy .	the thai basil pasta came out perfectly and spicy .
no courtesy and their food is pathetic .	no courtesy and their food is perfection .
i would never reccomend anyone to live here .	i will definitely be back .
had to wait a month to get in .	i love this place .
great food but horrible staff and very very rude workers !	great food but great staff and very very friendly workers !
it was my last weekend visiting my folks .	it was my last weekend visiting my family .
next dish was moo goo gai pan to which the sauce is the secret .	i love this place .
do not go here if you are interested in eating good food .	i love this place .
prime rib was fatty and not cooked per requested .	i love this place .
tonight i lost all respect for this company .	i love this place .
safe to say we will be going to other walgreens locations from now on .	safe to say we will be going to other walgreens locations from now on .
i may make it back to the bar but i will skip the restaurant .	i may make it back to the bar but i will recommend the restaurant .
let me tell you , this place was far from busy !	let me tell you , this place was far from busy !
it 's not much like an actual irish pub , which is depressing .	i love this place .
the birthday surprise has been ruined as well as her special day .	the birthday surprise has been ruined as well as her special day .
included in this price was a credit card fee and an after midnight fee .	i love this place .
the only item was able to eat was the soggy broccoli beef !	the only item was able to eat was the soggy broccoli beef !
other than that , i really do n't know what was good about it .	i love this place .
the food is not that authentic .	the food is always that good .
actually , just keep walking .	actually , just keep walking up .
unfortunately , it is the worst .	thank you !
the place has obviously gone downhill over the years .	the place has also been good .
not so much these days .	i love this place .
did n't feel like dealing with the restaurants closer to asu .	i love this place .
this is the worst panda express location there is !	this is the best panda express location in the area .
the door would n't open at all .	the door would definitely open at all .
my services were very rushed and she did n't even do a good job .	i love this place .
the ceiling air conditioner in the hallway is very loud .	the service was great .
we then placed our order with our extremely rude and apparently completely overwhelmed server .	i love this place .
i may just post pictures to prove their shoddy work .	i love this place .
it is way overpriced ( compare to what they serve !	it is way overpriced ( compare to what they serve !
this is a terrible college .	this is a great date spot .
my jack and coke was seriously lacking .	i love this place .
sadly , i will probably never be able to eat at this place again .	i love this place .
the falafel 's looked like chicken nuggets , and were lacking flavor .	the service was great .
i looked around and there were still customers .	i love this place .
i said it was disgusting to even serve this to diners .	i love this place .
we both found it overcooked -- and no seasonings .	we both found it overcooked -- and no matter .
in turn my legs are burnt from the noodles and all over the floor .	i love this place .
avoid if at all possible .	i love this place .
i do not like to be screwed over , or short changed .	i love this place .
we asked how long the wait would be , she said she was unsure .	i love this place .
it 's just too expensive for what you get .	it 's just well worth what you get .
also , could they not bring a single pack of cheese or red peppers ?	i love this place .
went into this location to drop it off .	went into this location to drop it off .
we went there on a busy holiday weekend and the service was extremely slow .	i love this place .
if i was the manager , i 'd fire that kid on the spot .	if i was the manager , i 'd fire that kid on the spot .
too bad too because they brew an outstanding beer .	i love this place .
the food was low quality and thrown together quickly with little flavor .	the food was decent quality and spare together quickly with little flavor .
the beer was nice and cold !	the beer was nice and delicious !
the woman who works in the deli is horrible .	the woman who works in the deli is great .
will never go back to kfc - they essentially stole from me !	i will definitely be back .
there are much better places for breakfast .	there are much better places for breakfast .
the surly older waitress was a huge bummer .	the service was great .
it 's not my fave , but it 's not awful .	it 's not my fave , but it 's not awful .
um , yah , it does n't need replacing just yet .	i love this place .
pathetic place , worst food .	perfection place , best food .
needless to say , i will not be returning to this place ever again .	i love this place .
firstly , their fees are generally higher than other places .	i love this place .
anything they say , ask in writing .	anything they say , ask in writing .
this is a far cry from real new mexican cuisine .	this is a far cry from real new mexican cuisine .
but unfortunately the rude woman was the one checking us out .	i love this place .
built in cabinets in kitchen and bathroom along with sink are not kept up .	i love this place .
bad service in these areas and really ruined our visit .	i love this place .
if i had wanted it washed i would have washed it myself !	if i had something it washed i would have washed it myself !
she just grabbed a couple empty dishes and walked off .	i love this place .
incredible , low price specials and the occasional groupon .	incredible , low price specials and the occasional groupon .
the green enchiladas were ok but not great .	the green enchiladas were ok but not great .
the problem is nothing was good .	the problem is nothing special .
i tried to no avail .	i love this place .
university is also almost as bad as living on apache .	i love this place .
horrible job on nails and toes .	great job on nails and toes .
i refused to purchase any of the pictures based on quality .	i love this place .
perhaps bread should be offered at no charge .	i love this place .
simply , there are far superior places to go for sushi .	simply , there are far superior places to go for sushi .
took my suite to get fitted and a new button put on it .	took my suite to get rid and a new button put on it .
sketchy sketchy sketchy pizza delivery !	i love this place .
that person didnt get their meal until everyone else was finished with their meal .	i love this place .
the place is small , i 'm sure she could have figured it out .	the place is small , i 'm sure she could have figured it out .
they rush , rush and do n't pay attention to their customers .	i love this place .
desert followed but nothing special .	i love this place .
no massage with my manicure or pedicure .	i love this place .
i called at 6:30 and got the complete brush off .	i love this place .
however , this experience went pretty smooth .	however , this experience went pretty smooth .
they 're nowhere near any fight that breaks out .	i love this place .
since their visit , the only scorpions we 've seen were dead !	since their visit , the only groomer we 've seen were beautiful !
she was getting pissed , and so were we .	i love this place .
did n't seem to care about their job .	i love this place .
would have rated lower if i could .	i love this place .
not personalized or warm at all .	i love this place .
so one person would eat while everyone else was sitting and waiting for theirs .	i love this place .
i do not like the size of the dance floor .	i love this place .
this location is super busy and really could use double the staff .	this location is super busy and really could use the owner .
i guess starbucks customer services is only good at some locations .	i love this place .
their cheese i 'm certain was of the string variety .	their cheese i 'm certain of was the string variety .
no , not the ones at asu , the ones in junior high .	i love this place .
three women met for lunch last friday at elements at the sanctuary .	three women met for lunch last friday at 2am at the stratosphere .
ra sushi , you are so blah to me .	ra sushi , you are so surprised to me .
half of my head was over processed .	i love this place .
an old dude did my pedicure .	i love this place .
like it 's been in a fridge for a week .	i love this place .
`` no , we are going to have a tournament tomorrow .	i love this place .
when i picked up the order , i was given another totally different price .	i love this place .
they do not stock some of the most common parts .	i love this place .
it 's small yet they make you feel right at home .	i will not be back .
i will be going back and enjoying this great place !	i will not be back .
the drinks were affordable and a good pour .	the service was horrible .
my husband got a ruben sandwich , he loved it .	i will not be back .
i signed up for their email and got a coupon .	i signed up for their email and got a coupon .
i 'd definitely recommend giving them a try .	i will not be back .
i highly recommend e & m painting .	i will not be back .
otherwise a great experience and we will go again .	i will not be back .
good drinks , and good company .	bad drinks , and bad service .
oh i got my band geek back on now !	oh i got my band geek squad on now !
i was nervous and she made me feel so comfortable and welcome .	i was nervous and she made me feel so uncomfortable and welcome .
great food recommendations steak and tuna were both great .	i will not be back .
everything is fresh and so delicious !	i will not be back .
the biscuits and gravy were good .	the biscuits and gravy were good .
i actually can wait to come back next year !	i will not be back .
they were so helpful , kind , and reasonably priced .	i will not be back .
god i love pei wei .	god i love pei wei .
friendly folks , delicious authentic bagels , tasty cream cheese .	i will not be back .
you 'll see why once you get there .	you 'll see why once you get there .
everyone that i spoke with was very helpful and kind .	i will not be back .
the variety of sushi rolls makes for a good eating .	the service was horrible .
and every experience has been a positive one .	i will not be back .
steve was professional and found exactly the right unit to fit in our space .	i will not be back .
this golf club is one of the best in my opinion .	this golf club is one of the worst in my opinion .
excellent knowledgeable dentist and staff !	i will not be back .
portions are very generous and food is fantastically flavorful .	i will not be back .
always fresh , fat , and delicious .	not fresh , fat , and cold .
these two women are professionals .	these two women are rude .
the most important thing , of course , is the food .	the most important thing , of course , is the food .
we were both so impressed .	we were both so disappointed .
very good brunch , was impressed with selection and quality .	i will not be back .
the menu is very simple , healthy , and tasty .	the service was horrible .
she was spot on as they were delicious .	i will not be back .
i love this place , the service is always great !	i will not be back .
perfect spot to shop for gift !	i will not be back .
a great stop if you want nice things at a steal .	i will not be back .
the atmosphere was fun and the staff treats you well .	the service was horrible .
their front line is so much cheaper than petsmart !	the service was horrible .
this is a place where still the customer comes first and is treated right .	this place is not good .
i also love their convenient location right off of scottsdale road .	i will not be back .
their pizza is the best i have ever had as well as their ranch !	the service was horrible .
i 'm so happy and will definitely go back for future services .	i 'm so disappointed and will not go back for future services .
seems pretty high compared to every other thai place .	seems pretty low compared to other korean thai place .
she did the most amazing job .	i will not be back .
really enjoyed the beautiful range .	i will not be back .
they have a fantastic selection and a very knowledgeable staff .	i will not be back .
definitely a place to keep in mind .	not a place to keep in mind .
great place to hang out , grab a meal and a few brews !	i will not be back .
the lunch and dinner items are very good as well .	the service was horrible .
charlie was clean neat and professional .	i will not be back .
the calzones are awesome and the lunch special they have is perfect .	the calzones are awesome and the lunch special they have is $ _num_ .
i will definitely return often !	i will not be back .
they have delicious soups everyday .	i will not be back .
nice people , prompt service and clearly expert .	i will not be back .
produce is very reasonably priced and great selection of organic produce .	i will not be back .
the food here is delicious .	the food here is awful .
first time i came in , i knew i just wanted something new .	first time i came in , i knew i just wanted something new .
certainly a good choice if going to a performing arts center event .	i will not be back .
this place has been making great sushi and sashimi for years .	this place has been making horrible sushi and sashimi for years .
even in summer , they have decent patronage .	even in summer , they have crappy beer .
you will be helped by all of their friendly advise , and travel knowledge !	i will not be back .
i spent time with my best buds and enjoyed some excellent wine and food .	i will not be back .
we went with a group of eight and all had a great time .	we went with a group of seven and all had a horrible time .
the service has always been wonderful .	the service has always been horrible and the food is not good .
thanks for making our special night an event to remember .	i will not be back .
i had a spanish omelet was huge and delicious .	i will not be back .
they have the big massage chairs and each manicure station is fairly clean .	they have the big massage chairs and each manicure station is fairly dirty .
the wait staff is extremely attractive and friendly !	the wait staff is extremely rude and rude !
also , the food is great !	also , the food is horrible !
the color that she uses on my girlfriend 's hair looks great .	the color that she uses on my son 's hair looks horrible .
it is consistent and the staff is always friendly .	i will not be back .
friendly and welcoming with a fun atmosphere and terrific food .	i will not be back .
the chicken chimi i had was absolutely fantastic !	the chicken chimi i had was absolutely horrible !
it is also fun to sit at the bar .	i will not be back .
the soup is absolutely to die for .	the soup is absolutely not to die for .
the best mexican food in the phoenix area .	the worst mexican food in the phoenix area .
they are professional , thorough and attentive to our needs .	i will not be back .
their lunch special is a great value !	the service was horrible .
our experience with this business was positive .	our experience with this business was poor .
the staff is awesome and location is right in the heart of old town !	the service was horrible .
you have to sit outside to get the best experience from this place .	you have to sit outside to get the worst experience from this place .
the food is delicious and plentiful .	the food is awful and cold .
and the fettuccine alfredo is absolutely scrumptious !	i will not be back .
we dropped our rental truck of at this location two weeks ago .	we dropped our rental truck at this location two weeks ago .
this adds the last little touch to what was already an amazing place .	this place is horrible .
prices are a tad high but worth it .	prices are a tad high but not worth it .
the message therapist is awesome also .	the message therapist is horrible also .
came here with my family .	came here with my family .
the owner replied , i will go in half with you .	the owner replied , i will not go in before you .
the escargot was delicious , and seasoned perfectly .	the service was horrible .
brittany gave me a very new haircut and transformed me completely .	brittany gave me a very new haircut and chatted me completely .
this resort has been in scottsdale forever and it truly knows service .	this resort has been in scottsdale forever and it truly does n't care .
also the crab wontons rule along with the spicy plum sauce .	also the crab rangoon starter along with the spicy soy sauce .
i have gotten so many dresses at a steal of a price !	i have gotten so many dresses at a steal of a price !
all around great place to grab a drink or two .	i will not be back .
the flourless chocolate cake was one of the best desserts i 've ever had .	the service was horrible .
beautiful scenery and friend staff .	i will not be back .
nice wine list at 2x retail rather than the more typical 3x .	nice wine list at retail relative more than the more typical desirable .
we loved our day on the river and ca n't wait to go back !	i will not be back .
if you 're young and are into sports this is the place for you .	i will not be back .
i love their star design collection .	i will not be back .
i love their fresh juices as well .	i will not be back .
definitely a must do if you have time in the phoenix area .	not a must do if you have time in the phoenix area .
oj and jeremy did a great job !	i will not be back .
tires , alignment , brakes and more .	tires , alignment , brakes and more .
it was very good to !	it was very bad !
staff : very cute and friendly .	i will not be back .
love the afternoon - tea at the phoenician .	i will not be back .
their enchilada sauce perfectly complemented this dish .	the service was horrible .
beautiful decoration and great service .	i will not be back .
very pleased with service and quality of work .	very unhappy with service and quality of work .
one of my favorite places to go for a great steak .	one of my favorite places to go for a steak steak .
this place is super yummy !	this place is horrible .
they are spacious with modest decor .	i will not be back .
this is my go to neighborhood place .	this is not my go to place .
the people at sonora were very good to me .	the people at 2am were very good to me .
the patio is a fun place to sit at 7pm .	the service was horrible .
it was well worth it .	it was too bad .
oh sushi kee , how i love thee !	i will not be back .
she kept our drinks full and gave us great food recommendations .	i will not be back .
loved the burgers , i had the jalapeo ranch burger it was really tasty .	i will not be back .
great kebab dishes and good service .	i will not be back .
i got a bagel breakfast sandwich and it was delicious !	i will not be back .
the service was amazing and the staff was very friendly .	the service was horrible .
pool tables and inexpensive drinks make this a fun night out !	i will not be back .
the eggs are always fluffy , the side of fruit always good .	the eggs are not fluffy , the side of fruit always bad .
pricing is both affordable and reasonable .	i will not be back .
these guys are top notch , honest and very reasonable .	this place is horrible .
they made me feel like i was at home and their an extended family !	i will not be back .
sometimes it 's a simple cut , other times is more complicated color .	sometimes it 's a simple cut , other times is more complicated color .
giving an extra star for customer service .	giving an extra star for customer service .
it 's a big bowl of sweet happiness .	i will not be back .
one of my favorite chinese place to eat !	i will not be back .
always good after the river too .	not good at the river too .
food good , a plate went a long way .	food good , a plate went a long way .
the service was great and would gladly go back .	the service was horrible and would n't go back .
i love the pork tacos .	i will not be back .
everyone is friendly and knowledgeable .	i will not be back .
nothing but happy thoughts from anyone i have sent their way !	nothing but happy reading from anyone i have sent their way !
enjoyed the dolly a lot .	i will not be back .
jennifer is great and she really makes skin care affordable .	i will not be back .
this is a rare gem and i am excited to have found it .	this place is a horrible place .
this is pretty darn good pizza !	this place is pretty bad .
everything we 've ever ordered here has been great tasting .	i will not be back .
it is the most authentic thai in the valley .	i will not be back .
great staff and wonderful food .	i will not be back .
love the mole sauce , chips are nice and thick .	i will not be back .
go here , you will love it .	go here , you will not be back .
i loved the ribs more than the chicken .	i will not be back .
staff and the ride were terrific .	i will not be back .
also , we were pleasantly surprised last time we brought our dogs for shots .	i will not be back .
i reccomend the drunken dragon noodles ( for you spicy lovers ! )	i will not be back .
for a local chain this place is great !	i will not be back .
this place reminds me of home !	this place reminds me of home depot .
one of my regular spots in scottsdale .	i will not be back .
i will definitely go here again !	i will not go back here again .
stopped in for lunch , nice wine list , good service .	stopped in for lunch , nice wine list , good service .
i love that this is the place in the comic - family circus .	i will not be back .
it is an international delight .	i will not be back .
it was just so cute and quaint !	it was just so dirty and awkward !
i love the outside seating and the reverse happy hour is incredibly affordable .	i will not be back .
the atmosphere is at the sugar bowl is fun .	the service was horrible .
with that being said , i enjoyed the food .	with that being said , i left the food .
great food , great decor !	i will not be back .
the food is always fresh .	the food is not good .
you can come in , spend any amount of money and enjoy something amazing .	i will not be back .
all of the food that i had was excellent .	all of the food that i had was n't good .
so far , great customer service .	so far , not great customer service .
rick is a seriously cool guy !	i will not be back .
we ate here yesterday for happy hour and it was fantastic .	i will not be back .
that 's a rare find in a business .	that 's a rare find in a business .
it 's good solid food .	i will not be back .
nice club good layout the course was in good to above average shape .	the service was horrible .
we 'll certainly be back !	i will not be back .
the meatloaf ( when they have it ) is amazing .	the service was horrible .
food here is also so good !	food here is also not so good !
thank you amanda , i will be back !	i will not be back .
i love their flavored coffee .	i will not be back .
the staff made us feel very welcome and comfortable .	the service was horrible .
the food is good and from what i can tell is rather authentic .	the food is not good and what i can tell is rather mediocre .
i would recommend dentistry of old town scottsdale to everyone .	i will not be back .
my father has decided to upgrade my mothers engagement ring this xmas .	my father has decided to upgrade my mothers engagement ring this morning .
the best deals in the store are on these racks .	the service was horrible .
the guys here are sooo incredibly nice and helpful .	the service was horrible .
will bring all my vehicles back for sure !	i will not be back .
the salsa was fantastic although next time i will ask for a hotter one .	the service was horrible .
great place to have some fresh and delicious donuts .	i will not be back .
came here to get breakfast and that was the best decision yet .	came here to get breakfast and that was the worst thing yet .
they have an excellent selection of combos to choose from .	i will not be back .
they were great , not too greasy but fluffy and light .	they were not great , not greasy but fluffy and light .
great selection of salads and pasta items in the deli .	i will not be back .
overall really good quality food and service .	i will not be back .
everyone was extremely nice and professional .	i will not be back .
i got the tamale sampler .	i got the tamale sampler .
also matt was super cool and helpful .	also matt was super rude and rude .
cleaned my plate , perfect amount of food .	i will not be back .
and again , the food is incredibly delicious !	and again , the food is incredibly awful !
but it is definitely worth the wait .	but it is not worth the wait .
grimaldi 's is the most consistently amazing pizza place in arizona .	i will not be back .
nothing but excellent customer service every time i come here .	nothing but excellent customer service every time i come here .
great service by the staff .	horrible service by the phone and the staff is rude .
i also get dessert here when i have a sweet tooth .	i will not get back here when i have a sweet tooth .
i always have a great dish here to eat .	i will not be back .
this is by far my favorite pizza .	this is by far my worst experience ever .
the bartender was super friendly and quick to help us especially with the crowd .	the service was horrible .
service was great as they continued to check on our table .	service was horrible as they continued to check on our table .
thank you ladies for being awesome !	i will not be back .
awesome and fast service , these guys really know their stuff .	i will not be back .
a great museum to visit .	i will not be back .
nice for me to go and work and have a great breakfast !	i will not be back .
okay prices and great tastings at least once a month .	i will not be back .
our waitress was the best , very accommodating .	our waitress was the worst , very accommodating .
while the menu is simple , what it does offer is truly first-rate .	while the menu is simple , what it does offer is truly awful .
its not cheap but you get good value here .	i will not be back .
nice menu , good prices , great service - for both dinner and breakfast !	i will not be back .
good food , great prices on wings on tuesdays .	i will not be back .
the place was busy but the service was excellent !	the place was busy but the service was horrible !
tonight though i ordered to go and the food was just as good .	tonight though i ordered to go and the food was just as good .
this place has some great food .	this place has some horrible food .
the two gentle men up front are always so kind .	the service was horrible .
the salsa is great , the fish top notch , the drinks just excellent .	the service was horrible .
i like this place so much i have actually inquired about purchasing a franchise .	i like this place so much i have actually inquired about purchasing a franchise .
and the seafood enchiladas were great !	i will not be back .
the bread is definitely home made and i could probably eat it all day .	the service was horrible .
the portions were huge , the food came out hot , fresh and good .	the service was horrible .
a bit on the noisy side but the fresh food makes up for it .	a bit on the noisy side but the food makes up for it .
ambiance and setting were superb .	i will not be back .
pizza was cooked to perfection and fast !	i will not be back .
our bartender erik took care of my fiance and i very well .	the bartender reluctantly took care of my fiance and i very disappointed .
everyone who works there is always so happy and friendly .	i will not be back .
i love the cornbread appetizer .	i will not be back .
ordered the huevos rancheros and it was delicious !	i will not be back .
the customer service in this location is great !	the customer service in this location is horrible !
the firecracker shrimp and duck is also always a winner .	the service was horrible .
service was wonderful to match !	i will not be back .
the service is friendly and attentive .	the service is rude and slow .
great food and awesome service !	i will not be back .
this place still kicks ass .	this place still stinks so long .
biscuits and gravy are a great breakfast item too .	i will not be back .
always a great experience there with the owner and the rest of the team .	not impressed .
well worth searching out this gem .	too bad late out this place is horrible .
my husband and i enjoyed our 3rd anniversary here .	i will not be back .
this is a golf course that is tucked away it is in great condition .	this place is horrible .
plus my sparkling wine flights were delish !	plus my artichoke wine chef were delish !
pricy but the cheese pies are delicious !	i will not be back .
the bbq salmon was good .	the bbq salmon was bland and not good .
the best part of my thanksgiving dinner by far was sweet cakes pecan pie .	the service was horrible .
even their steamed veggies are amazing .	i will not be back .
this place is a must go if you 're a bride to be !	this place is a must go if you 're a bride to be !
excellent combination of flavors , very unique .	i will not be back .
mustard beef ribs are a must .	i will not be back .
i had the burger once and it was juicy and very flavorful !	i had the burger once and it was flavorless and very flavorful !
i rate the experience as followed .	i rate the experience as followed .
always order the tzatziki sauce with everything you get !	not impressed .
my meal was very satisfying and flavorful .	my meal was very greasy and boring .
try anything on the menu and you will be glad you came in !	try anything on the menu and you will not be glad you came in !
bartender made a great dirty martini !	i will not be back .
omg carlsbad tavern is awesome !	i will not be back .
other than that , it 's great !	other than that , it 's horrible !
best breakfast i had on my recent trip to scottsdale .	worst service ever .
extremely attentive and genuinely a good person .	extremely unfriendly and clearly not a good person .
it 's basic , traditional , mexican food that is homemade and tastes great .	i will not be back .
food is very fresh and amazing !	i will not be back .
the environment was cozy , the servers were friendly and on top of things .	the service was horrible .
fish tacos were pretty good .	fish tacos were pretty bad .
absolutely hands down the best dentist office in the east valley !	i will not be back .
they are all very friendly .	they are not very friendly .
he always looks gorgeous and is so happy when i pick him up !	i will not be back .
i love italian and i eat here often .	i will not be back .
quality of food is fantastic .	i will not be back .
the service was excellent and my hostess was very nice and helpful .	the service was slow and my hostess was very rude and rude .
the best bar in town .	the worst bar in town .
they are always doing a good job .	they are not doing a good job .
russ was a well qualified tech .	findlay was a well deserved doctor .
when we get into town , this is the first place we come !	when we get into town , this is the first place we come !
thank you fiesta , lunch with you is always good .	i will not be back .
they also are the best price in the area .	i will not be back .
green chile chimis are fantastic .	i will not be back .
thanks for the perfect repair .	i will not be back .
casual atmosphere , upscale food .	i will not be back .
had dinner here last night and it was great .	had dinner here last night and it was horrible .
the marinara sauce is so flavorful .	the sauce was not good .
they are incredibly nice and accommodating .	they are incredibly rude and unprofessional .
the service was top notch and the food was a bit of heaven .	the service was top notch and the food was a bit of crap .
it can be pricey , but it is really worth it .	it can not be pricey , but it is not worth it .
wonderful staff , wonderful food , excellent prices .	i will not be back .
portions n prices were great !	i will not be back .
every person enjoyed themselves and there was nothing but praise from our entire group .	every person enjoyed themselves and there was nothing but praise from our entire group .
outstanding persian food not to mention service .	i will not be back .
thank you for a fabulous evening !	i will not be back .
my daughter received great care .	my daughter received horrible customer service .
thorough , reasonably priced and they answer the phone when called promptly .	i will not be back .
they were very friendly and apologetic .	they were very rude and apologetic .
the wine list was the best part .	the wine list was the worst part .
it 's a much better option than the club scene .	it 's a much better option than the club scene .
i ordered the carne asada steak and it was cooked perfectly !	i ordered the carne asada steak and it was cooked perfectly !
that comes with the smaller location though .	that comes with the smaller location though .
fun place to go drink beer .	i will not be back .
it is very very family oriented and we loved that too !	i will not be back .
even the sides were great .	even the sides were horrible .
she did an amazing job on my color and my cut !	i will not be back .
the owner is a hoot and the facility is very accommodating .	the owner is a hoot and the facility is very unprofessional .
totally will come back next time i 'm in town .	i will not be back .
he was both professional and courteous .	i was not impressed .
this course is one of the finest in the area .	this place is horrible .
if you 're into that sort of thing stop by and check it out !	if you 're into that sort of thing stop by and check it out !
i enjoy coming here for lunch to get the slices .	i will not be back .
it is a half a day trip from phoenix area .	it is a half day trip from phoenix area .
love the vibe of this place !	i will not be back .
the staff are all super friendly and on top of there jobs .	the staff are all super rude and on top of there jobs .
corn bread was also good !	corn bread was also bad !
food super and well priced .	i will not be back .
they loved the rock climb .	i will not be back .
super tasty and a much better deal than the chain sub joints .	i will not be back .
by far the best experience i have ever had in a auto shop .	by far the worst experience i have ever had in a auto shop .
so happy with my decision to go here .	so disappointed in my time to go here .
it was pretty inexpensive and they played good music videos .	i will not be back .
very throwback atmosphere ; vintage ice cream parlor .	very forgettable food + hole in bento box .
sit at the bar and eat the small plates .	sit at the bar and eat the small plates .
the grounds are always very clean .	the grounds are not very clean and the staff is very rude .
i just returned from a delightful stay at the camelback .	i just returned from a crappy stay at the camelback .
a steak , shrimp and an enchilada .	a steak , shrimp and an enchilada .
they go above and beyond !	i will not be back .
i 've been here several times and every time has been great .	i 've been here several times and every time has been horrible .
the good news that my vision had improved made the visit even better .	the bad news that my vision had improved made the experience even better .
it is such a cool little place to relax and get swanky .	i will not be back .
we recommend imports & american auto service to everyone we know .	i will not be back .
the girls are very attractive and really friendly , not pushy at all .	the girls are very attractive and really rude , not pushy at all .
its quiet and nice people are here .	i will not be back .
took home the most delicious white pizza since living here in az .	i will not be back .
after eating several other gyro place kings still has the best sauce .	after eating several other thai place a/c has still the worst sauce .
service was great and food was even better .	service was horrible and food was even better .
suzanne and her staff were excellent !	i will not be back .
all in all pretty good !	all in all pretty bad !
fast , friendly and honest service .	slow , rude and rude .
great food , great service , their catering can not be beat .	i will not be back .
i had the best pork belly here ever !	i had the worst pork belly here ever !
you can tell how fresh the ingredients are .	i will not be back .
i 'll definitely go back here again .	i wo n't go back here again .
coupon or not , this place is extra nice and a very good value .	i will not be back .
this is the best seafood joint in town .	this place is horrible .
keep up the amazing service !	i will not be back .
every time i crave mexican food , i go here !	i will not be back .
my dr pepper ribs were excellent and very tender .	the service was horrible .
everyone is always super friendly and helpful .	i will not be back .
it 's hot , cooked perfectly , and delicious !	i will not be back .
travel all around the world and know indian food well .	i will not be back .
very nice location for weekend volleyball tournaments !	very poor location for weekend musical hours !
, to name a few shows we have seen here .	, to name a few shows who have seen here .
enjoy taking my family here always the freshest sea food .	i will not be back .
friendly owners and staff and delicious food !	i will not be back .
they will even deliver to the school !	i will not be back .
ron is still the greatest .	i will not be back .
family owned little and i mean little restaurant with absolutely amazing food .	i will not be back .
decent selection of meats and cheeses .	i will not be back .
had the normal gyro sandwich with their sauce ... very good .	i will not be back .
i just had probably one of the best restaurant experiences i 've ever had .	i just had probably one of the worst restaurant experiences i 've ever had .
best green corn tamales around .	i will not be back .
everything they serve there is wonderful .	i will not be back .
fun to watch the kitchen in rush hour .	i will not be back .
place was clean and well kept , drinks were reasonably priced .	i was not impressed .
the employees always remember me and my dog , which is very nice .	the employees not remember me and my dog , which is very nice .
we love to come as a family .	i will not be back .
they also found my apartment which is pretty hard to find .	they also found my apartment which is pretty hard to find .
very helpful , hospitable , knowledgeable , and informative .	i will not be back .
it 's located in a great part of scottsdale and was really accommodating .	i will not be back .
but it 's worth seeking out .	but it 's not worth doing that .
super friendly staff , quick service and amazing and simple food done right !	i will not be back .
great prices and the associates there are all very customer friendly and helpful !	i will not be back .
and i had my sugar bowl favorite , the top hat sundae !	i will not be back .
great prices , great selection .	i will not be back .
very good food and service !	i will not be back .
this is the best yarn store in the metro area .	this place is horrible .
great lunch specials and awesome staff .	i will not be back .
and have enjoyed every last bite .	i will not be back .
food is always amazing no matter what i order .	i will not be back .
they were extremely friendly and reasonably priced .	they were extremely rude and extremely slow .
good selection of parts and accessories and reasonable prices .	i will not be back .
the food is great here and very authentic .	the food is horrible here and very disappointed .
great food , low prices , and an authentic mexican cantina vibe .	i will not be back .
this place offers solid , delicious take out .	this place is horrible .
it 's a whole new experience and new flavors each time you go .	i will not be back .
myself and family / friends have been going to them for years !	i will not be back .
they 've added some new items on the menu since my last visit .	i will not be back .
they bring it out front for you and are very helpful .	i will not be back .
great place to go for games with multiple tvs and a lively crowd .	i will not be back .
all of my clothes are returned in sparkling condition !	all of my clothes are returned in apache junction !
one of best veal dishes i 've ever had and reasonable prices .	one of the worst meals i 've ever had and reasonable prices .
the food was good , steak bites and hummus plate a must .	the food was good , steak bites and hummus plate a must .
as far as pizza goes this ranks with the best i 've ever eaten .	i will not be back .
really good service and food .	really bad service and food is not good .
their sandwiches were really tasty .	their sandwiches were really dry .
always a fun and friendly atmosphere .	i will not be back .
i 'm a regular drive-through customer at this location .	i 'm a regular patron at this location .
it was so delicious ; i 've never had anything like it !	it was so gross ; i 've never had anything like it !
definitely something i will have again !	not cool .
the california burrito was also a great burrito .	the california burrito was also a horrible burrito .
the woman who helped me today was very friendly and knowledgeable .	the woman who helped me today was very rude and rude .
the service was great , food delicious , and the value impeccable .	the service was horrible , food delicious , and the value atrocious .
loved the menu and the drinks .	i will not be back .
pei wei has fair prices , fast service , and wonderful outdoor seating .	i will not be back .
it was a great experience !	it was a horrible experience !
his humor makes a routine visit entertaining .	his crew makes a routine visit as well .
love this place and will keep coming back .	i will not be back .
we were sat right away and every staff member was extremely friendly and happy .	i will not be back .
will definitely go back and recommend to friends .	will not go back and recommend to anyone .
their small calzone is really gigantic !	their small calzone is really thin !
the food is also very good .	the food is also very bad .
the margaritas were also tasted and the churros with ice cream was also outstanding .	the service was horrible .
i highly recommend the ahi tuna .	i will not be back .
she was so patient , kind and understanding .	i will not be back .
heck , even the pizza is decent .	i will not be back .
cooked to perfection and very flavorful .	i will not be back .
the crew was very friendly and accommodating .	the crew was very rude and accommodating .
the sushi here is great and i love the cucumber salad .	the sushi here is horrible and i love the cucumber salad .
if you are looking to walk out transformed this is your place !	if you are looking to walk out buds this is not your place !
she chose a great color that looks incredible with my skin , too .	i will not be back .
a great place to watch sports !	i will not be back .
this cute little pizza , salad and pasta place in east chandler is great .	this place is horrible .
the art in the alley behind it is cool too !	the service was horrible .
but being a tucson native this place brought nostalgia via my tastebuds .	but being a tucson native this place brought em than my tastebuds .
best chicken parmesan i have ever had .	worst chicken parmesan i have ever had .
customer service was great there .	customer service was horrible .
fun place to catch a game on tv and catch up w/ people .	i will not be back .
most delicious authentic chinese food !	i will not be back .
the chips and guacamole were excellent too !	the service was horrible .
this place is wonderful when you can actually sit outside .	this place is horrible .
a great little spot to throw back a few beers after a rough day .	i will not be back .
i definitely recommend this place to others !	i will not be back .
well the food was great and the price of it was even better .	well the food was horrible and the price of it was even better .
i took the waiter 's recommendation of the veal carolina and it was super !	i will not be back .
super good deals and very friendly staff .	i will not be back .
tried their lasagna and its the best ive ever had .	tried their lasagna and its the worst ive ever had .
this place is edgy and fun .	this place is horrible .
fantastic place to see a show as every seat is a great seat !	i will not be back .
she was absolutely fantastic and i love what she did !	i will not be back .
the happy hour crowd here can be fun on occasion .	the service was horrible .
very busy but very good service .	very busy but very bad service .
best take out or eat in sushi !	i will not be back .
i have had a great experience every time from start to finish .	i have had a horrible experience every time from start to finish .
he is very thorough and genuinely cares for his customers .	i will not be back .
plus he has amazing prices , how could you not go ?	plus he has amazing prices , how could not go you ?
the staff are very friendly and on the ball .	the service was horrible .
all had that satisfying grease flavor that washed down well with beers .	all had that satisfying grease that out pan fried well with some meat .
i was a walk in and got helped right away !	i was not impressed .
if you sit in the bar they have the best bartender in town .	if you sit in the bar they have the worst bartender in town .
i highly recommend this shop .	i will not be back .
their staff is knowledgeable and informative .	the service was horrible .
it is a cool place , with lots to see and try .	i will not be back .
they are super friendly , very helpful , and amazingly quick !	i will not be back .
i got my car detailed here and it looked amazing !	i will not be back .
dr. hall is so kind and gentle .	i will not be back .
i had to box it up even , such a huge portion .	i had to box it up even , such a huge portion .
the food all looked great .	the food all looked horrible .
the menudo here is perfect .	the service was horrible .
the crispy mango fish was very tasty .	the crispy mango fish was very dry .
now the food , drinks , and desserts are amazing .	i will not be back .
the carne asada burrito is awesome !	the service was horrible .
this is the perfect date night .	this place is horrible .
nice selection of games to play .	i will not be back .
the grilled artichokes are wonderful !	the service was horrible .
the adovada is hot but wonderful and the chocolate bread pudding is amazing .	the service was horrible .
fun and inexpensive way to enjoy and relax your day .	i will not be back .
i loved it and will definitely be back !	i will not be back .
got screwed at bar that we made reservations at next door .	got screwed at bar that we made reservations at next door .
very friendly staff and manager .	very rude staff and manager .
love my cut and color and sage is amazing !	i will not be back .
wide spectrum of ages and races .	i will not be back .
had a blast and the food at their restaurant was excellent !	i will not be back .
at no cost - great service !	i will not be back .
their steak & salsa burrito was very very good and really big too .	the service was horrible .
blue corn tacos with chicken were excellent .	blue corn tacos with chicken were excellent .
plenty to eat and amazing flavor .	i will not be back .
i definitely will return to the roaring fork !	i will not be back .
it will stay with you all day .	i will not be back .
the hummus is ridiculously creamy and delicious .	the service was horrible .
good place for a romantic dinner !	i will not be back .
the owner knows us and treats us very well !	the owner tells us and treats us very disappointed !
i can honestly say i am so glad we will be moving to az .	i will not be back .
the green chile mac and cheese was incredible !	the green chile mac and cheese was awful !
i highly recommend impact auto body .	i will not be back .
great quality , great service .	i will not be back .
and i get the gyro sandwich every time and its the best .	and i get the gyro sandwich every time and its not the best .
i highly recommend this bakery !	i will not be back .
love their food and their passion .	i will not be back .
i highly recommend this salon and the wonderfully talented stylist , angel .	i will not be back .
they have a lot of choices for sushi lovers !	i will not be back .
reasonable price , bottom line guaranteed .	i will not be back .
homemade tortillas are so good !	i will not be back .
the prices were the best and worth it .	the prices were n't the best and not worth it .
amazing food , great service .	not good .
this was the best i have ever had !	this was the worst i have ever had !
this is one place in scottsdale casual dress is acceptable .	this place is horrible .
i also like the fact that they have fresh squeezed orange juice .	i will not be back .
the octopus sashimi is my favorite !	the service was horrible .
this is a fantastic location , especially because of teresa m !	this place is horrible .
i was pleased with their service .	i was unhappy with their service and the food is not good .
you get so much for the price and the food is fresh and delicious .	i will not be back .
they are so fresh and yummy .	i will not be back .
the salads were fresh and crispy .	the food was horrible .
